11111111111111
10000000000001
10000000000001

10000P000000E1
1000C000000001
11111111111111