1111111111
1000000001
10001P0001
1001C1E001
1111111111